##########
#........#
#@......M#
#........#
#........#
##########
