##########
#........#
#@.......#
#........#
#........#
##########
